336
20
135 136 137 138 139 140 141 142 135 136 137 138 139 140 141 142 135 136 137 138 139 140 141 142 135 136 137 138 139 140 141 142 135 136 137 138 139 140 141 142 135 136 137 138 139 140 141 142 135 136 137 138 139 140 141 142 135 136 137 138 139 140 141 142 135 136 137 24  25  26  27  28  135 136 137 138 139 140 141 142 135 136 137 138 139 140 141 142 135 136 137 138 139 140 141 142 135 136 137 138 139 140 141 142 135 136 137 138 139 140 141 142 135 136 137 138 139 140 141 142 135 136 137 138 139 140 141 142 135 136 137 138 139 140 141 142 135 136 137 138 139 140 141 142 135 136 137 138 139 140 141 142 135 136 137 138 139 140 141 142 135 136 137 138 139 140 141 142 0   0   0   24  25  26  27  28  0   0   0   0   0   0   0   0   0   0   0   0   0   0   0   0   0   0   0   0   24  25  26  27  28  0   0   0   0   0   0   0   0   0   0   0   0   0   0   0   0   0   0   0   0   0   0   0   0   0   0   0   24  25  26  27  28  0   0   0   0   0   0   0   0   0   0   0   0   0   0   0   0   0   0   0   0   0   0   0   0   0   0   0   0   0   0   24  25  26  27  28  0   0   0   0   0   0   0   0   0   0   0   0   0   0   0   0   135 136 137 138 139 140 141 142 135 136 137 138 139 140 141 142 135 136 137 138 139 140 141 142 135 136 137 138 139 140 141 142 135 136 137 138 139 140 141 142 135 136 137 138 139 140 141 142 135 136 137 138 
123 0   0   0   0   0   0   24  25  26  27  28  0   0   0   0   0   0   0   0   0   0   0   0   0   0   0   0   0   0   0   0   0   0   0   0   0   63  64  0   63  64  0   63  64  0   63  64  0   0   0   0   0   0   0   0   0   0   0   0   0   0   0   0   0   0   0   29  30  31  32  33  0   0   0   0   0   0   0   0   0   0   0   0   0   0   0   0   0   0   0   0   0   0   0   0   0   0   0   0   0   0   0   0   0   0   0   0   0   0   0   24  25  26  27  28  0   0   0   0   0   0   0   24  25  26  27  28  0   0   0   0   0   0   0   24  25  26  27  28  0   0   0   0   0   0   0   0   0   0   0   0   0   0   0   0   0   0   0   0   0   0   0   0   0   0   0   125 0   0   0   29  30  31  32  33  0   0   0   0   0   0   0   0   0   0   0   0   0   0   0   0   0   0   0   0   29  30  31  32  33  0   0   0   0   0   0   0   0   0   0   0   0   0   0   0   0   0   0   0   0   0   0   0   0   0   0   0   29  30  31  32  33  0   0   0   0   0   0   0   0   0   0   0   0   0   0   0   0   0   0   0   0   0   0   0   0   0   0   0   0   0   0   29  30  31  32  33  0   0   0   0   0   0   0   0   0   0   0   0   0   0   0   0   0   0   0   0   0   0   0   0   0   0   0   0   0   0   0   0   0   0   0   0   0   0   0   0   0   0   0   0   0   0   0   0   0   0   0   0   0   0   0   0   0   0   0   0   0   131 132 133 134 131 132 133
124 0   0   0   0   0   0   29  30  31  32  33  0   0   0   0   0   0   0   0   0   0   0   0   0   0   0   0   0   0   0   0   0   0   0   0   0   61  62  0   61  62  0   61  62  0   61  62  0   63  64  0   0   0   0   0   0   0   0   0   0   0   0   0   0   0   0   34  35  36  37  38  0   0   0   0   0   0   0   0   0   0   0   0   0   0   0   0   0   0   0   0   0   0   0   0   0   0   0   0   0   0   0   0   0   0   0   0   0   0   0   29  30  31  32  33  0   0   0   0   0   0   0   29  30  31  32  33  0   0   0   0   0   0   0   29  30  31  32  33  0   0   0   0   0   0   0   0   0   0   0   0   0   0   0   0   0   0   0   0   0   0   0   0   0   0   0   123 0   0   0   34  35  36  37  38  0   0   0   0   0   0   0   0   0   0   0   0   0   0   0   0   0   0   0   0   34  35  36  37  38  0   0   0   0   0   0   0   0   0   0   0   0   0   0   0   0   0   0   0   0   0   0   0   0   0   0   0   34  35  36  37  38  21  22  23  0   0   0   0   0   0   0   0   0   0   0   0   0   0   0   0   0   0   0   0   0   0   0   0   0   0   0   34  35  36  37  38  0   0   0   0   0   0   0   0   0   0   0   0   0   0   0   0   0   0   0   0   0   0   0   0   0   0   0   0   0   0   0   0   0   0   0   0   0   0   0   0   0   0   0   0   0   0   0   0   0   0   0   0   0   0   0   0   0   0   0   0   0   135 136 137 138 135 136 137
125 0   0   0   0   0   0   34  35  36  37  38  0   0   0   0   0   0   0   0   0   0   0   0   0   0   0   0   0   0   0   0   0   0   0   0   143 144 145 143 144 145 143 144 145 143 144 145 0   61  62  0   0   0   0   0   0   0   0   0   0   0   0   0   0   0   0   39  40  39  0   40  0   0   0   0   0   0   0   0   0   0   0   0   0   0   0   0   0   0   0   0   0   0   0   0   0   0   0   0   0   0   0   0   0   0   0   0   0   0   0   34  35  36  37  38  0   0   0   0   0   0   0   34  35  36  37  38  0   0   0   0   0   0   0   34  35  36  37  38  0   0   0   0   0   0   0   0   0   0   0   0   0   0   0   0   0   0   0   0   0   0   0   0   0   0   0   124 0   0   0   39  40  39  0   40  0   0   0   0   0   0   0   0   0   0   0   0   0   0   0   0   0   0   0   0   39  40  39  0   40  0   0   0   0   0   0   0   0   0   0   0   0   0   0   0   0   0   0   0   0   0   0   0   0   0   0   0   39  40  39  0   40  18  19  20  0   0   0   0   0   0   0   0   0   0   0   0   0   0   0   0   0   0   0   0   0   0   0   0   0   0   0   39  40  39  0   40  0   0   0   0   0   0   0   0   0   0   0   0   0   0   0   0   0   0   0   0   0   0   0   0   0   0   0   0   0   0   0   0   0   0   0   0   0   0   0   0   0   0   0   0   0   0   0   0   0   0   0   0   0   0   0   0   0   0   0   0   0   139 140 141 142 139 140 141
123 0   0   0   0   0   0   39  40  39  0   40  0   0   0   0   0   0   0   0   0   0   0   0   0   0   0   0   0   0   0   0   0   0   0   144 146 147 148 146 147 148 146 147 148 146 147 148 143 144 145 143 144 145 0   0   0   0   0   0   0   0   0   0   0   0   0   0   0   0   0   0   0   0   0   0   0   0   0   0   0   0   0   0   0   0   0   0   65  66  67  68  69  70  71  72  73  0   0   0   0   0   0   0   0   0   0   0   0   0   0   39  40  39  0   40  0   0   0   0   0   0   0   39  40  39  0   40  0   0   0   0   0   0   0   39  40  39  0   40  0   0   0   0   0   0   0   0   0   0   0   0   0   0   0   0   0   0   0   0   0   0   0   0   0   0   0   125 0   0   0   0   0   0   0   0   0   0   0   0   0   0   0   0   0   0   0   0   0   0   0   0   0   0   0   0   0   0   0   0   0   0   0   0   0   0   0   0   0   0   0   0   0   0   0   0   0   0   0   0   0   0   0   0   0   0   0   0   0   0   0   0   0   15  16  17  0   0   0   0   0   0   0   0   0   0   0   0   0   0   0   0   0   0   0   0   0   0   0   0   0   0   0   0   58  21  22  23  0   0   0   0   0   0   0   0   0   0   0   0   0   0   0   0   0   0   0   0   0   0   0   0   0   0   0   0   0   0   0   0   0   0   0   0   0   0   0   0   0   0   0   0   0   0   0   0   0   0   0   0   0   0   0   0   0   0   0   0   41  135 136 137 138 135 136 137
124 0   0   0   0   0   0   0   0   0   0   0   0   0   0   0   0   0   0   0   0   42  43  0   0   0   0   0   0   0   0   0   0   0   143 147 0   0   0   0   0   0   0   0   0   0   0   0   146 147 148 146 147 148 143 0   0   0   0   0   0   0   0   0   0   0   0   0   0   0   0   0   0   0   0   0   0   0   0   0   0   0   0   0   0   0   0   0   74  75  76  77  78  79  80  81  82  0   0   0   0   0   0   0   0   0   0   0   0   0   0   0   0   0   0   0   0   0   0   0   0   0   0   0   0   0   0   0   0   0   0   0   0   0   0   0   0   0   0   0   0   0   0   0   0   0   0   0   0   0   0   0   0   0   0   0   0   0   0   0   0   0   0   0   0   0   0   123 0   0   0   0   0   0   0   0   0   0   0   0   0   0   0   0   0   0   0   0   0   0   0   0   0   0   0   0   0   0   0   0   0   0   0   0   0   0   0   0   0   0   0   0   0   0   0   0   0   0   0   0   0   0   0   0   0   0   0   0   0   0   0   0   131 132 133 134 131 132 133 134 0   0   0   0   0   0   0   0   0   0   0   0   0   0   0   0   0   0   0   0   0   0   0   0   0   18  19  20  0   0   0   0   0   0   65  66  67  68  69  70  71  72  73  0   0   0   0   0   0   0   0   0   0   0   0   0   0   0   0   0   0   0   0   0   0   0   0   0   0   0   0   0   0   0   0   0   0   0   0   0   0   0   0   0   0   0   0   0   0   139 140 141 142 139 140 141
125 5   6   7   8   0   0   0   0   0   0   0   0   0   0   0   0   0   63  64  0   44  45  0   0   0   0   0   0   0   0   0   0   145 146 0   0   0   0   0   56  57  58  0   0   0   0   0   0   0   0   0   0   0   146 144 0   0   0   0   0   0   0   0   0   0   0   0   0   0   0   0   0   0   0   0   0   0   0   0   0   0   0   0   0   0   0   0   0   83  84  85  86  87  88  89  0   0   0   0   0   0   0   0   0   0   0   0   0   0   0   0   0   0   0   0   0   0   0   0   0   0   0   0   0   0   0   0   0   0   0   0   0   0   0   0   0   0   0   0   0   0   0   0   0   65  66  67  68  69  70  71  72  73  0   0   0   0   0   0   0   0   0   0   0   0   0   124 0   0   0   0   0   0   0   0   0   0   0   0   0   0   0   0   0   0   0   0   0   0   0   0   0   0   0   0   0   0   0   0   0   0   0   0   0   0   0   0   0   0   0   0   0   0   0   0   0   0   0   0   0   0   0   0   0   0   0   0   0   0   0   0   135 136 137 138 135 136 137 138 0   0   0   0   0   0   0   0   0   0   0   0   0   0   0   0   0   0   0   0   0   0   0   0   0   15  16  17  0   0   0   0   0   0   74  75  76  77  78  79  80  81  82  0   0   0   0   0   0   0   0   0   0   0   0   0   0   0   0   0   0   0   0   0   0   0   0   0   0   0   0   0   0   0   0   0   0   0   0   0   0   0   0   0   0   0   0   0   0   135 136 137 138 135 136 137
158 1   2   3   4   0   0   0   0   0   0   0   0   0   0   0   0   0   61  62  0   0   0   0   0   0   0   63  64  0   0   0   144 148 0   0   0   0   0   0   48  49  59  0   0   0   0   0   0   0   0   0   0   0   0   147 145 0   0   0   0   0   0   0   0   0   0   0   0   0   0   0   0   0   0   0   0   0   0   0   0   0   0   0   0   0   0   0   0   0   0   90  91  92  0   0   0   0   0   0   0   0   0   0   0   0   0   0   0   0   0   0   0   0   0   0   0   0   0   0   0   0   0   0   0   0   0   0   0   0   0   0   0   0   0   0   0   0   0   0   0   0   0   0   0   74  75  76  77  78  79  80  81  82  0   0   0   0   0   0   0   0   0   0   0   0   41  125 0   0   0   0   0   0   0   0   0   0   0   0   0   0   0   0   0   0   0   0   0   0   0   0   0   0   0   0   0   0   0   0   0   0   0   0   0   0   0   0   0   0   0   0   0   0   0   0   0   0   0   0   131 132 133 134 131 132 133 134 131 132 133 134 139 140 141 142 139 140 141 142 131 132 133 134 0   0   0   0   0   0   0   0   0   0   0   41  131 132 133 134 131 132 133 134 131 132 133 134 0   0   0   0   0   0   0   83  84  85  86  87  88  89  0   0   0   0   0   0   0   0   0   0   0   0   0   0   131 132 133 134 131 132 133 134 131 132 133 134 0   0   0   0   0   0   0   0   0   0   0   0   0   0   0   0   0   0   0   0   0   139 140 141 142 139 140 141
123 154 156 155 63  64  0   0   0   0   0   0   0   0   0   0   143 144 145 143 144 145 143 144 145 0   0   61  62  0   0   143 147 0   48  49  0   0   0   0   50  51  60  0   0   0   0   0   0   0   0   0   0   0   0   0   148 143 0   0   0   0   0   0   0   0   0   0   0   0   0   0   0   0   0   0   0   0   93  94  0   0   0   0   102 100 0   0   0   0   0   0   0   0   0   0   0   0   0   0   0   0   0   0   0   0   0   0   0   0   0   0   0   0   0   0   0   0   0   0   0   0   0   0   0   0   0   0   0   0   0   0   0   0   0   0   0   0   0   0   0   0   0   0   0   0   83  84  85  86  87  88  89  0   0   0   0   0   0   0   0   0   0   0   0   0   0   117 118 0   0   0   0   0   0   0   0   0   0   0   0   0   0   0   0   0   0   0   0   0   0   0   0   0   0   0   0   0   0   0   0   0   0   0   0   0   0   0   0   0   0   0   0   42  43  0   0   0   0   0   135 136 137 138 135 136 137 138 135 136 137 138 135 136 137 138 135 136 137 138 135 136 137 138 0   0   0   0   0   0   0   0   0   0   149 150 135 136 137 138 135 136 137 138 135 136 137 138 0   0   0   0   0   0   0   0   0   90  91  92  0   0   0   0   0   0   0   0   0   0   0   0   0   0   0   0   135 136 137 138 135 136 137 138 135 136 137 138 149 150 0   0   0   0   0   0   0   0   0   0   0   0   0   0   0   0   0   0   0   135 136 137 138 135 136 137
124 151 152 153 61  62  0   0   0   0   0   0   0   0   0   157 146 147 148 146 147 148 146 147 148 143 144 145 143 144 145 146 0   0   50  51  0   0   0   0   52  53  0   0   0   0   0   0   0   0   0   0   0   0   0   0   0   146 144 0   0   0   0   0   0   0   0   0   0   0   0   0   0   0   0   0   0   0   95  96  97  0   0   102 101 98  0   0   0   0   0   0   0   0   0   0   0   0   0   0   0   0   0   0   0   0   0   0   0   0   0   0   0   0   0   0   0   0   0   0   0   0   0   0   0   0   0   0   0   0   0   0   0   0   0   0   0   0   42  43  0   0   0   0   0   0   0   0   90  91  92  0   0   0   0   0   0   0   0   0   0   0   0   0   0   0   0   119 120 0   0   0   0   0   0   0   0   0   0   0   0   0   0   0   0   0   0   0   0   0   0   0   0   0   0   0   0   0   0   0   0   0   0   0   0   0   0   0   0   0   0   0   0   44  45  0   131 132 133 134 139 140 141 142 139 140 141 142 139 140 141 142 139 140 141 142 139 140 141 142 139 140 141 142 131 132 133 134 0   0   0   0   0   0   0   0   139 140 141 142 139 140 141 142 139 140 141 142 131 132 133 134 0   0   0   0   0   0   0   0   0   0   0   0   131 132 133 134 0   0   0   0   0   0   149 150 139 140 141 142 139 140 141 142 139 140 141 142 0   0   0   0   0   0   0   0   0   0   0   0   0   0   0   0   0   0   0   0   0   139 140 141 142 139 140 141
125 143 144 145 143 144 145 0   0   0   143 144 145 143 144 145 0   0   0   0   0   0   0   0   0   146 147 148 146 147 148 0   0   0   52  53  0   0   0   0   0   0   0   0   0   0   0   0   0   0   0   0   0   0   0   0   0   0   147 145 0   0   0   0   0   0   0   0   0   0   0   0   0   0   0   0   0   0   0   103 104 105 106 107 98  0   0   0   0   0   0   0   0   0   0   0   0   0   0   0   0   0   0   0   0   0   0   0   42  43  0   0   0   0   0   0   0   0   0   0   0   0   0   0   0   0   0   0   0   0   0   0   0   0   0   0   0   0   44  45  0   0   0   0   0   0   0   0   0   0   0   0   0   0   0   0   0   0   0   0   0   0   0   0   0   0   0   121 122 0   0   0   0   0   0   0   0   0   0   0   0   21  22  23  0   0   0   0   0   0   0   0   0   0   0   0   0   0   0   0   0   0   0   0   0   21  22  23  0   0   0   0   0   0   0   0   135 136 137 138 135 136 137 138 135 136 137 138 135 136 137 138 135 136 137 138 135 136 137 138 135 136 137 138 135 136 137 138 0   0   0   0   0   0   0   0   135 136 137 138 0   58  56  57  135 136 137 138 135 136 137 138 0   0   0   0   0   0   0   0   0   0   0   0   135 136 137 138 0   0   0   0   0   0   0   0   135 136 137 138 135 136 137 138 135 136 137 138 0   0   0   0   0   0   0   0   0   0   0   0   0   0   0   0   0   0   0   0   0   135 136 137 138 135 136 137
123 146 147 148 146 147 148 0   0   0   146 147 148 146 147 148 0   0   56  57  58  0   0   0   0   0   0   0   0   0   0   0   0   0   0   0   0   0   0   0   0   0   0   0   0   0   0   0   0   0   0   0   0   0   0   0   0   0   0   148 143 0   0   0   0   0   0   0   0   0   0   0   0   0   0   0   0   0   0   0   109 110 111 112 0   0   0   0   0   0   0   0   0   0   0   0   0   0   0   0   0   0   0   154 156 155 63  64  44  45  0   0   0   0   0   0   0   0   0   0   0   0   0   0   0   0   0   0   0   0   0   0   0   0   0   63  64  0   0   0   0   0   0   0   0   0   0   0   0   0   0   0   0   0   0   0   0   0   0   0   0   0   0   0   143 144 145 143 131 132 133 134 131 132 133 134 0   0   0   0   0   18  19  20  0   0   0   0   0   0   0   0   131 132 133 134 156 155 0   0   0   0   0   0   0   18  19  20  0   0   0   0   131 132 133 134 139 140 141 142 139 140 141 142 139 140 141 142 139 140 141 142 139 140 141 142 139 140 141 142 139 140 141 142 139 140 141 142 131 132 133 134 0   0   149 150 139 140 141 142 0   59  48  49  139 140 141 142 139 140 141 142 131 132 133 134 131 132 133 134 131 132 133 134 139 140 141 142 131 132 133 134 131 132 133 134 139 140 141 142 139 140 141 142 139 140 141 142 149 150 0   0   0   0   0   0   0   0   0   0   0   0   0   0   0   0   0   0   0   139 140 141 142 139 140 141
124 0   0   0   56  57  58  0   0   0   58  56  57  0   0   0   0   0   48  49  59  0   0   0   0   0   0   0   0   0   0   0   0   0   0   0   0   0   0   0   0   0   0   0   0   0   0   0   0   0   0   0   0   0   0   0   0   0   0   0   146 144 0   0   63  64  9   10  11  12  13  14  63  64  11  12  63  64  0   0   113 114 115 0   0   0   0   0   0   0   0   0   0   0   0   0   0   0   0   0   0   0   0   151 152 153 61  62  0   63  64  0   63  64  0   63  64  0   63  64  0   0   0   63  64  0   63  64  0   0   63  64  0   0   0   61  62  0   0   0   0   0   0   0   0   0   0   0   0   0   0   0   0   0   0   0   0   0   0   0   0   143 144 145 146 147 148 146 135 136 137 138 135 136 137 138 131 132 133 134 0   15  16  17  0   0   0   0   0   0   0   0   135 136 137 138 152 153 0   0   0   0   0   0   0   15  16  17  0   0   0   157 135 136 137 138 135 136 137 138 135 136 137 138 135 136 137 138 135 136 137 138 135 136 137 138 135 136 137 138 135 136 137 138 135 136 137 138 135 136 137 138 0   0   0   0   135 136 137 138 0   60  50  51  135 136 137 138 135 136 137 138 135 136 137 138 135 136 137 138 135 136 137 138 135 136 137 138 135 136 137 138 135 136 137 138 135 136 137 138 135 136 137 138 135 136 137 138 0   0   149 150 0   0   0   0   0   0   0   0   0   0   0   0   0   0   0   0   0   135 136 137 138 135 136 137  
125 0   0   0   48  49  59  0   0   0   59  54  55  0   0   0   0   0   50  51  60  0   0   0   0   0   0   0   0   0   0   0   0   0   0   0   0   0   0   0   0   0   0   0   0   0   0   0   0   0   0   0   0   0   0   0   0   0   0   0   0   147 145 0   61  62  0   0   0   0   0   0   61  62  0   0   61  62  0   0   0   0   0   0   0   0   126 127 128 129 130 0   0   0   0   0   0   0   0   0   0   0   143 144 145 143 144 145 0   61  62  0   61  62  0   61  62  0   61  62  143 144 145 61  62  0   61  62  0   0   61  62  0   0   143 144 145 143 144 145 0   0   0   0   0   0   0   0   42  43  0   0   0   0   0   0   0   0   143 144 145 146 147 148 0   0   0   0   139 140 141 142 139 140 141 142 135 136 137 138 131 132 133 134 131 132 133 134 131 132 133 134 139 140 141 142 131 132 133 134 131 132 133 134 131 132 133 134 131 132 133 134 139 140 141 142 139 140 141 142 139 140 141 142 139 140 141 142 139 140 141 142 139 140 141 142 139 140 141 142 139 140 141 142 139 140 141 142 139 140 141 142 131 132 133 134 139 140 141 142 0   0   52  53  139 140 141 142 139 140 141 142 139 140 141 142 139 140 141 142 139 140 141 142 139 140 141 142 139 140 141 142 139 140 141 142 139 140 141 142 139 140 141 142 139 140 141 142 0   0   0   0   149 150 0   0   0   0   0   0   0   0   0   0   0   0   0   0   0   139 140 141 142 139 140 141  
123 0   0   0   50  51  60  0   0   0   60  48  49  46  0   0   0   0   52  53  0   0   0   0   0   0   0   0   0   0   0   0   0   0   0   0   0   0   0   0   0   0   0   0   0   0   0   0   0   0   0   0   0   0   0   0   0   0   0   0   0   0   148 143 144 145 143 144 145 143 144 145 143 144 145 143 144 145 143 144 145 143 144 145 143 144 145 143 144 145 143 144 145 143 144 145 143 144 145 143 144 145 146 147 148 146 147 148 143 144 145 143 144 145 143 144 145 143 144 145 146 147 148 143 144 145 143 144 145 143 144 145 143 144 146 147 148 146 147 148 143 144 145 0   0   0   63  64  44  45  63  64  0   0   0   143 144 145 146 147 148 0   0   0   0   0   0   0   0   0   0   0   56  57  58  0   139 140 141 142 135 136 137 138 135 136 137 138 135 136 137 138 135 136 137 138 135 136 137 138 135 136 137 138 135 136 137 138 135 136 137 138 135 136 137 138 135 136 137 138 135 136 137 138 135 136 137 138 135 136 137 138 135 136 137 138 135 136 137 138 135 136 137 138 135 136 137 138 135 136 137 138 135 136 137 138 135 136 137 138 0   0   0   0   135 136 137 138 135 136 137 138 135 136 137 138 0   58  56  57  135 136 137 138 135 136 137 138 135 136 137 138 135 136 137 138 135 136 137 138 135 136 137 138 135 136 137 138 0   0   0   0   0   0   149 150 0   0   0   0   0   9   10  11  12  13  14  0   0   117 118 0   42  43  0   158
124 0   0   0   52  53  0   0   0   0   0   50  51  47  0   0   0   0   0   0   0   0   0   0   0   0   0   0   0   0   0   0   0   0   0   0   0   0   0   0   0   0   0   0   0   0   0   0   0   0   0   0   0   0   0   0   0   0   0   0   0   0   0   146 147 148 146 147 148 146 147 148 146 147 148 146 147 148 146 147 148 146 147 148 146 147 148 146 147 148 146 147 148 146 147 148 146 147 148 146 147 148 0   0   0   0   0   0   146 147 148 146 147 148 146 147 148 146 147 148 0   0   0   146 147 148 146 147 148 146 147 148 146 147 0   0   0   0   0   0   146 147 148 143 144 145 61  62  0   0   61  62  143 144 145 146 147 148 0   0   0   0   0   0   0   0   0   0   0   0   0   0   48  49  59  46  135 136 137 138 139 140 141 142 139 140 141 142 139 140 141 142 139 140 141 142 139 140 141 142 139 140 141 142 139 140 141 142 139 140 141 142 139 140 141 142 139 140 141 142 139 140 141 142 139 140 141 142 139 140 141 142 139 140 141 142 139 140 141 142 139 140 141 142 139 140 141 142 139 140 141 142 139 140 141 142 139 140 141 142 0   0   0   0   139 140 141 142 139 140 141 142 139 140 141 142 0   59  48  49  139 140 141 142 139 140 141 142 139 140 141 142 139 140 141 142 139 140 141 142 139 140 141 142 139 140 141 142 0   0   0   0   0   0   0   0   131 132 133 134 0   0   0   0   0   0   0   0   0   119 120 0   44  45  0   158
125 0   0   0   0   0   0   0   0   0   0   52  53  0   0   0   0   0   0   0   0   0   0   0   0   0   0   0   0   0   0   0   0   0   0   0   0   0   0   0   0   0   0   0   0   0   0   0   0   0   0   0   0   0   0   0   0   0   0   0   0   0   0   0   0   0   0   0   0   0   0   0   0   0   0   0   0   0   0   0   0   0   0   0   0   0   0   0   0   0   0   0   0   0   0   0   0   56  57  58  0   0   0   0   0   0   0   0   0   0   0   0   56  57  58  0   0   0   0   0   56  57  58  0   0   0   0   0   0   0   0   0   0   0   0   0   0   0   0   0   0   0   0   146 147 148 143 144 145 143 144 145 146 147 148 0   0   0   0   0   0   0   0   0   0   0   0   0   0   0   0   0   50  51  60  47  139 140 141 142 135 136 137 138 135 136 137 138 135 136 137 138 135 136 137 138 135 136 137 138 58  56  57  58  0   0   0   0   135 136 137 138 135 136 137 138 135 136 137 138 135 136 137 138 135 136 137 138 135 136 137 138 135 136 137 138 135 136 137 138 135 136 137 138 135 136 137 138 135 136 137 138 135 136 137 138 135 136 137 138 0   0   0   0   135 136 137 138 135 136 137 138 135 136 137 138 0   60  50  51  135 136 137 138 135 136 137 138 135 136 137 138 135 136 137 138 135 136 137 138 135 136 137 138 135 136 137 138 0   0   0   0   0   0   0   0   135 136 137 138 0   0   0   0   0   0   0   0   0   121 122 0   0   0   0   158
123 0   0   0   0   0   58  0   0   0   58  0   0   0   0   0   0   0   0   0   0   0   0   0   0   0   0   0   0   0   0   0   0   0   0   0   0   0   0   0   0   0   0   0   0   0   0   0   0   0   0   0   0   0   0   0   0   0   0   0   0   0   0   0   0   0   0   0   0   0   0   0   0   0   0   0   0   0   0   0   0   0   0   0   0   0   0   0   0   0   0   0   0   0   0   0   0   48  49  59  46  0   0   0   0   0   0   0   0   0   0   0   48  49  59  46  0   0   0   0   48  49  59  46  0   0   0   0   0   0   0   0   0   0   0   0   0   0   0   0   0   0   0   0   0   0   146 147 148 146 147 148 0   0   0   0   0   0   0   0   0   0   0   0   0   0   0   0   0   0   0   0   52  53  0   0   135 136 137 138 139 140 141 142 139 140 141 142 139 140 141 142 139 140 141 142 139 140 141 142 59  48  49  59  46  0   0   0   139 140 141 142 139 140 141 142 139 140 141 142 139 140 141 142 139 140 141 142 139 140 141 142 139 140 141 142 139 140 141 142 139 140 141 142 139 140 141 142 139 140 141 142 139 140 141 142 139 140 141 142 0   0   0   0   139 140 141 142 139 140 141 142 139 140 141 142 0   0   52  53  139 140 141 142 139 140 141 142 139 140 141 142 139 140 141 142 139 140 141 142 139 140 141 142 139 140 141 142 131 132 133 134 131 132 133 134 139 140 141 142 131 132 133 134 131 132 133 134 131 132 133 134 131 132 133 134
124 0   0   0   0   0   59  0   0   0   59  0   0   0   0   0   0   0   0   0   0   0   0   0   0   0   0   0   0   0   0   0   0   0   0   0   0   0   0   0   0   0   0   0   0   0   0   0   0   0   0   0   0   0   0   0   0   0   0   0   0   0   0   0   0   0   0   0   0   0   0   0   0   0   0   0   0   0   0   0   0   0   0   0   0   0   0   0   0   0   0   0   0   0   0   0   0   50  51  60  47  0   0   0   0   0   0   0   0   0   0   0   50  51  60  47  0   0   0   0   50  51  60  47  0   0   0   0   0   0   0   0   0   0   0   0   0   0   0   0   0   0   0   0   0   0   0   0   0   0   0   0   0   0   0   0   0   0   0   0   0   0   0   0   0   0   0   0   0   0   0   0   0   0   0   0   139 140 141 142 135 136 137 138 135 136 137 138 135 136 137 138 135 136 137 138 135 136 137 138 60  50  51  60  47  0   0   0   135 136 137 138 135 136 137 138 135 136 137 138 135 136 137 138 135 136 137 138 135 136 137 138 135 136 137 138 135 136 137 138 135 136 137 138 135 136 137 138 135 136 137 138 135 136 137 138 135 136 137 138 0   0   0   0   135 136 137 138 135 136 137 138 135 136 137 138 0   0   0   0   135 136 137 138 135 136 137 138 135 136 137 138 135 136 137 138 135 136 137 138 135 136 137 138 135 136 137 138 135 136 137 138 135 136 137 138 135 136 137 138 135 136 137 138 135 136 137 138 135 136 137 138 135 136 137 138
125 0   0   0   0   0   60  0   0   0   60  0   0   0   0   0   0   0   0   0   0   0   0   0   0   0   0   0   0   0   0   0   0   0   0   0   0   0   0   0   0   0   0   0   0   0   0   0   0   0   0   0   0   0   0   0   0   0   0   0   0   0   0   0   0   0   0   0   0   0   0   0   0   0   0   0   0   0   0   0   0   0   0   0   0   0   0   0   0   0   0   0   0   0   0   0   0   52  53  0   0   0   0   0   0   0   0   0   0   0   0   0   52  53  0   0   0   0   0   0   52  53  0   0   0   0   0   0   0   0   0   0   0   0   0   0   0   0   0   0   0   0   0   0   0   0   0   0   0   0   0   0   0   0   0   0   0   0   0   0   0   0   0   0   0   0   0   0   0   0   0   0   0   0   0   0   0   0   0   0   139 140 141 142 139 140 141 142 139 140 141 142 139 140 141 142 139 140 141 142 0   52  53  0   0   0   0   0   139 140 141 142 139 140 141 142 139 140 141 142 139 140 141 142 139 140 141 142 139 140 141 142 139 140 141 142 139 140 141 142 139 140 141 142 139 140 141 142 139 140 141 142 139 140 141 142 139 140 141 142 0   0   0   0   139 140 141 142 139 140 141 142 139 140 141 142 0   0   0   0   139 140 141 142 139 140 141 142 139 140 141 142 139 140 141 142 139 140 141 142 139 140 141 142 139 140 141 142 139 140 141 142 139 140 141 142 139 140 141 142 139 140 141 142 139 140 141 142 139 140 141 142 139 140 141 142